2 2 2 2 2 2 2 2 2 2 2 2 2 2 2 2 2 2 2 2 2 2 2 2
2 0 0 0 0 0 0 0 0 0 0 0 0 0 0 0 2 0 0 0 0 0 0 2
2 0 6 0 0 0 0 0 0 0 0 0 0 0 0 0 0 0 0 0 0 0 0 2
2 0 6 0 0 0 0 0 0 0 0 0 0 0 0 0 0 0 0 0 0 0 0 2
2 0 6 0 0 0 0 0 0 0 0 0 0 0 0 0 7 0 0 0 0 0 0 2
2 0 6 0 0 0 0 5 5 5 5 5 5 5 5 5 7 7 0 7 7 7 7 2
2 0 6 0 0 0 0 5 0 5 0 5 0 5 0 5 7 0 0 0 7 7 7 2
2 0 6 0 0 0 0 5 0 0 0 0 0 0 0 5 7 0 0 0 0 0 0 2
2 0 6 0 0 0 0 0 0 0 0 0 0 0 0 0 0 0 0 0 7 7 7 2
2 0 6 0 0 0 0 5 0 0 0 0 0 0 0 5 7 0 0 0 0 0 0 2
2 0 0 0 0 0 0 5 0 0 0 0 0 0 0 5 7 0 0 0 7 7 7 2
2 0 0 0 0 0 0 5 5 5 5 0 5 5 5 5 7 7 7 7 7 7 7 2
2 6 6 6 6 6 6 6 6 6 6 0 6 6 6 6 6 6 6 6 6 6 6 2
2 0 0 0 0 0 0 0 0 0 0 0 0 0 0 0 0 0 0 0 0 0 0 2
2 6 6 6 6 6 0 6 6 6 6 0 6 6 6 6 6 6 6 6 6 6 6 2
2 4 4 4 4 4 0 4 4 4 6 0 6 2 2 2 2 2 2 2 3 3 3 2
2 0 0 0 0 0 0 0 0 4 6 0 6 2 0 0 0 0 0 2 0 0 0 2
2 0 0 0 0 0 0 0 0 0 0 0 6 2 0 0 5 0 0 2 0 0 0 2
2 0 0 0 0 0 0 0 0 4 6 0 6 2 0 0 0 0 0 2 2 0 2 2
2 0 6 0 6 0 0 0 0 4 6 0 0 2 0 0 5 0 0 0 0 0 0 2
2 0 0 5 0 0 0 0 0 4 6 0 0 2 0 0 0 0 0 2 2 0 2 2
2 0 6 0 6 0 0 0 0 4 6 0 0 0 0 0 5 0 0 2 0 0 0 2
2 0 0 0 0 0 0 0 0 4 6 0 0 0 0 0 0 0 0 2 0 0 0 2
2 2 2 2 2 2 2 2 2 2 2 2 2 2 2 2 2 2 2 2 2 2 2 2
