5 5 5 5 5 5 5 5 5 5 5 1 1 1 1 1 1 1 1 1 1 1 1 1
5 0 0 0 0 0 0 0 0 0 5 5 0 0 0 0 0 0 0 0 0 0 0 1
5 0 5 5 0 0 0 0 0 5 5 5 0 0 0 0 5 0 6 0 5 0 0 1
5 0 0 5 0 0 8 0 0 0 0 0 0 0 0 0 0 0 0 0 0 0 0 1
5 0 5 5 0 0 0 0 0 5 5 5 0 0 0 0 0 0 0 0 0 0 0 1
5 0 0 0 0 0 0 0 0 0 5 5 0 0 0 0 0 6 6 6 0 6 6 1
5 5 5 5 0 5 5 5 5 5 5 5 5 5 5 5 5 6 0 0 0 0 0 5
5 5 5 5 0 5 5 5 5 0 5 0 5 0 5 0 5 5 0 5 0 5 0 5
5 5 0 0 0 0 0 0 5 5 0 5 0 5 0 5 5 5 0 0 0 0 0 5
5 0 0 0 0 0 0 0 0 0 0 0 0 0 0 0 5 5 0 0 0 0 0 5
5 0 0 0 0 0 0 0 0 0 0 0 0 0 0 0 5 5 0 5 0 5 0 5
5 5 0 0 0 0 0 0 5 5 0 5 0 5 0 5 5 5 5 5 0 5 5 5
5 5 5 5 0 5 5 5 5 5 5 5 0 5 5 5 5 5 5 5 0 5 5 5
7 7 7 7 0 7 7 7 7 5 5 5 0 0 6 0 6 5 0 0 0 0 0 5
7 7 0 0 0 0 0 7 7 5 0 0 0 0 0 0 5 5 0 0 0 0 0 5
7 0 0 0 0 0 0 0 7 5 0 0 0 0 0 0 5 5 0 0 0 0 0 5
7 0 0 0 0 0 0 0 8 5 5 5 5 5 6 0 6 5 5 0 0 0 5 5
7 0 0 0 0 0 0 0 7 7 7 8 7 7 7 6 6 0 0 5 0 5 0 5
7 7 0 0 0 0 0 7 7 7 0 0 0 7 7 0 5 0 5 0 0 0 5 5
7 0 0 0 0 0 0 0 7 0 0 0 0 0 7 5 0 5 0 5 0 5 0 5
8 0 0 0 0 0 0 0 0 0 0 0 0 0 0 0 0 0 0 0 0 0 0 5
7 0 0 0 0 0 0 0 7 0 0 0 0 0 7 5 0 5 0 5 0 5 0 5
7 7 0 0 0 0 0 7 7 7 0 0 0 7 7 0 5 0 5 0 0 0 5 5
7 7 7 7 8 7 7 7 7 7 7 8 7 7 7 5 5 5 5 5 5 5 5 5
